+-+-+-+-+-+-+-+-+-+-+-+-+-+-+-+-+-+-+-+-+-+-+-+-+-+-+-+-+-+-+-+-+-+-+-+-+-+-+-+-+-+-+-+-+-+-+-+-+-+-+-+-+-+-+-+-+-+-+-+-+-+-+-+-+-+-+-+-+-+-+
|@|       |         |       |     |             |     |         |   |     |         |               |         |       |     |       |     | |
+ + +-+-+ + + +-+-+ + +-+-+ + + + +-+-+-+ +-+-+ + +-+ + +-+-+ + + + +-+-+ +-+-+-+-+ + +-+ +-+ +-+-+ +-+ +-+-+ + +-+-+-+ +-+ +-+-+-+ +-+-+ + +
| |   |   | | |   | | |   |   | |     | | |   | |   | | |   | | | | |   | |   |   | | |     | |   |     |   | | |     | | | |   |     |   | |
+ +-+ + +-+-+ + +-+ + + + +-+-+ +-+-+ + + + + + +-+-+ + +-+ + + + + + + + + + +-+ + + + +-+ + + +-+-+-+-+ + + + + +-+ + + + + + +-+-+ + +-+ +
|     | |   | |   |   | |       |     |   | |   |   |       | | | |   |   | |   |   | | |   |   |       | |   |   |   |   | | |     | | |   |
+-+-+-+ + + + + + +-+-+ +-+-+-+-+ +-+-+-+ + +-+-+ + + + +-+-+-+ + +-+-+-+ + +-+ + +-+ + + +-+-+ + +-+-+ + +-+-+-+-+ +-+ +-+ + +-+-+ + + +-+ +
|     | | |   | |   | | |   |   |         |   |   | | |   | |   |   | |   |   | | |   | |     | | | |   |   |     |   | |   | |     | |   | |
+ +-+ + + +-+-+ +-+ + + +-+ + + +-+-+-+-+-+-+ + +-+ +-+-+ + + +-+-+ + + +-+ +-+ + +-+-+ +-+-+ + + + + +-+-+ + +-+ +-+ +-+ +-+-+ +-+-+ +-+ + +
|   |     |   |   | |   |   | |     |           |         | | |   | | |   | |   |     |   |   | | | | |   | | |     |   | |           |   | |
+-+ +-+ +-+ + +-+ + +-+ + +-+ +-+-+-+ +-+-+-+ +-+ +-+-+-+-+ + + + + + + + + + +-+-+-+ +-+ +-+-+ + + + + + + + + +-+-+-+ + + +-+ +-+-+-+ +-+ +
|   | | |   |   | |   |       | |     |       | |   |     | |   |   | | | | | |         |   | | | | | | |   | |   |       | |         |   | |
+ +-+ + + +-+-+ +-+-+ + +-+-+-+ + +-+-+ +-+-+ + +-+ +-+-+ + +-+-+-+-+ +-+ +-+ +-+-+-+-+ +-+ + + + + + +-+ +-+ +-+ + +-+ +-+ + + +-+-+ +-+ + +
|   |   |     |         |     | | |   |   |   |   |   |   | | |           |     | |       | |   |   |     |   |   |   |     | | |   |   | | |
+-+ +-+-+-+-+ +-+-+-+-+-+ + + + + +-+ +-+ + +-+-+ +-+ + +-+ + + +-+-+-+-+-+ + + + + +-+-+ + +-+-+-+-+ +-+-+ +-+ +-+-+ +-+-+ + +-+ + +-+ + + +
|   |       |         |   | |   |     |   |   |   |   |   |         |   |   | | |   |     | |       |     | |   |   |     | |   | |   | |   |
+ +-+ +-+-+ +-+-+-+-+ +-+-+-+-+ +-+-+-+-+-+-+ + + + +-+ + +-+-+-+-+ + + + +-+ + +-+ + + +-+ + + +-+-+-+-+ + + +-+-+ +-+-+ +-+-+ + +-+ + + + +
|   |   | |         |     |   | |         | | | | |   | |   |       | | | | | |   | | | |   | |         |   |     |   | | |   | |   |   | | |
+-+ +-+ + +-+-+-+-+ +-+-+ + + + + +-+-+-+ + + + + + + + +-+-+ +-+-+-+ + + + + +-+ +-+ +-+ + +-+-+-+-+-+ +-+-+-+-+ +-+ + + + + + +-+-+-+-+ + +
| | |   | | |     | |     | | | |   |   |     | |   | |               | | |   |   |       | |   |   |   |       |   |     | | |       |   | |
+ + + +-+ + + +-+ + + +-+-+ + + +-+ + + +-+-+-+ +-+-+ + +-+-+-+-+-+-+-+ + +-+-+ +-+ + +-+-+-+ + + + + +-+-+ +-+ +-+ +-+ +-+ + +-+-+-+ +-+-+ +
|   |   | | |   | | |   |   | |     | |   |   |     | | |   |     |     |     | |   |     |   |   | |     | | |   |   | |   |       |     | |
+-+-+-+ + + +-+ + + +-+ + +-+ +-+-+-+ +-+-+ + +-+-+ +-+ + + +-+-+ + +-+-+-+ + + + +-+-+ +-+ + +-+ +-+-+ + + + +-+ +-+ + + +-+-+-+-+ +-+ +-+ +
|   |     | | | | |   | | | | |     |       |     |   | | |   |   | |   |   | |   |       | |   |     | | | |     |   | | |     | |     |   |
+ +-+ + +-+ + + +-+-+ + + + + + +-+-+-+-+-+-+-+-+ +-+ + +-+-+ + +-+ + + +-+-+ +-+-+-+-+ + + +-+ +-+-+ + + + +-+ +-+ +-+ + + +-+ + +-+ +-+ +-+
| |   | |   | |     |   | |   |       |         |     |         | |   |   |   |       | |   |   |   |   | |   |       | | |   |   | |   |   |
+ + + + + +-+ +-+-+ + +-+ +-+-+-+-+ + + +-+-+-+ +-+ +-+-+-+-+ +-+ +-+-+ + + +-+ +-+ +-+ + +-+ +-+ +-+-+-+-+ + +-+-+ + + + + +-+-+-+ +-+-+-+ +
| | | | | |   |   | |   | |   |   | |   | |   | | | |   |         |   | |   |   |   |   | |   |   |     |   | |     | | |       |   |       |
+ + + + + + +-+ + + +-+ + +-+ + + +-+-+-+ + + + + + + + + +-+ +-+-+ + +-+-+-+ +-+-+-+ +-+ +-+ + + + + +-+ +-+-+ +-+-+ + + + +-+-+ + + +-+ +-+
|   | |   |     | |   | |   |   |   |     | | |   | | |   |   |   | | |   |           | |   | | |   |     | |   | |   | | |       |   | | | |
+-+-+-+-+ + +-+-+ +-+ +-+-+ +-+-+-+ +-+ + + + +-+ + +-+-+-+ +-+-+ + + + + + +-+-+-+-+-+ +-+ +-+ +-+ +-+ +-+ + +-+ + +-+ +-+-+-+-+-+-+-+ + + +
|   |       |     |   |       |   |   | |   |     | |   |     |     |   | |     |       |   |     | |   |   |     |     |       |     |   | |
+ + + +-+-+-+ + +-+ +-+ +-+ + + +-+-+ +-+-+ +-+-+ + + + +-+ +-+ +-+-+-+-+ +-+-+ + +-+-+-+ +-+ +-+-+ + +-+ +-+-+-+-+-+-+ + +-+ + +-+-+ +-+-+ +
| | |   |   | |   |       | |     |   |     |   | |   |   |   | |   |   |   |   |     |   | | |     |     |     |       | | | | |     |     |
+ +-+-+ + + + +-+-+-+-+-+-+ +-+-+ + +-+ +-+-+ + +-+-+-+-+ +-+ + + + + + +-+ + +-+ +-+ + +-+ + +-+-+-+-+-+-+ +-+ + + +-+-+ + + + + +-+-+ + +-+
| |     | | |               |     |   |       |       |   |   |   |   | | |   |   |     |   |   |       |   |   | |     | | | |   |     | | |
+ + +-+-+ + +-+-+-+-+-+-+-+-+ +-+-+-+ + +-+-+-+-+-+ + + +-+ +-+-+-+-+-+ + +-+-+-+-+-+-+-+ + +-+ + +-+-+ +-+ + +-+-+-+-+ + + + +-+-+ +-+-+ + +
|   |     | |           |         |   |   | |     | |   | | |       |     |   |     |   | |     | |     |   | | |       | |   |   | |   |   |
+ +-+ +-+-+ + +-+-+-+-+-+ +-+ +-+-+ + +-+ + + +-+ + +-+ + + + +-+-+-+ + +-+ + + + + +-+ + +-+-+-+-+ + +-+ +-+ + + +-+-+-+ + +-+ + + + +-+ + +
|     |     |               |       |   |   |   |   |   |   |         |     |   | |     |           |     |   |           |     |   |     |X|
+-+-+-+-+-+-+-+-+-+-+-+-+-+-+-+-+-+-+-+-+-+-+-+-+-+-+-+-+-+-+-+-+-+-+-+-+-+-+-+-+-+-+-+-+-+-+-+-+-+-+-+-+-+-+-+-+-+-+-+-+-+-+-+-+-+-+-+-+-+-+