+-+-+-+-+-+-+-+-+-+-+-+-+-+-+-+-+-+-+-+-+-+-+-+-+-+-+-+-+-+-+-+-+-+-+-+-+-+-+-+-+-+-+-+-+-+-+-+-+-+-+-+-+-+-+-+-+-+-+-+-+
|@    |   |       |     |             |   |           |       |   |           |     |       |         |     |       |   |
+ +-+ + + + +-+-+ + +-+-+ +-+-+-+-+-+ + + +-+-+ +-+ + + +-+ + + + + +-+-+-+-+ + +-+ + +-+-+ + +-+-+ + + +-+ + +-+-+ + +-+
| | | | | | |     |     | |         | | |     |   | | | |   |   | |         | |   | | |   | |     | | | |   |   |   |   |
+ + + + + + + +-+-+ +-+ + +-+-+-+-+ + +-+-+-+ +-+-+ + + + +-+-+-+ +-+-+-+-+ +-+-+ +-+ + + + +-+-+-+ + + + +-+-+ + +-+-+ +
|   |   | | |   |   |   |   |     |   |             | | |   |   |   |   |       |     | | |   |   | | | |     | |     | |
+ +-+-+-+ + +-+ + +-+ +-+-+ + +-+ +-+-+ +-+-+ +-+-+-+-+ +-+ + + +-+ + + + +-+-+ +-+-+-+ + +-+ + + + +-+ +-+-+ +-+-+ + + +
|   | |   |   |   |   |       | |       |     |     |   |   | |     | |   |   |     |   |   |   | |   |   | | |     | | |
+-+ + + +-+-+ +-+-+ +-+ +-+ +-+ +-+-+-+-+ +-+ + +-+ + +-+-+-+ +-+-+ + +-+ + + +-+-+ + + +-+ +-+-+ + + +-+ + + + +-+-+ + +
|   |   |   | |   |     |     | |       |   | | | | |     |   |   | |   |   |   | |   |   | |     | |   |   |   |   | | |
+ +-+-+-+ + + + + + +-+-+ +-+ + + +-+-+ +-+ +-+ + + +-+-+ + +-+ + + +-+ +-+-+-+ + +-+-+-+ + +-+ +-+-+-+ +-+ +-+-+ + +-+ +
|       | |   | |   |     |   | | |   |     |   | |       |     | |   |   |   | | |       |   | |     |   |   | | | |   |
+-+-+ +-+ +-+-+ +-+-+ +-+-+ +-+ + + +-+-+ +-+ +-+ +-+-+-+-+-+-+ + +-+-+-+-+ + + + + +-+-+-+-+ + + +-+ +-+ +-+ + + + + + +
|     |   | |   |     |   |   | | |     |   |       |     |   | |         | | |   | |   |     | |   |   | |   |   |   | |
+ +-+-+ +-+ + +-+ +-+-+ + + + + + +-+-+ +-+-+-+ +-+-+ +-+ + +-+ +-+-+-+-+ + + +-+-+ + + + +-+ + +-+ + +-+ + +-+ +-+ +-+-+
| |   | |   |   |       | | | | | |   |   |   | |   | |   |   |   | |   | | |         | | |   | |   | |     |   |   |   |
+ + + + + + +-+ +-+-+-+-+ +-+ + + + + + +-+ +-+ + + +-+ +-+-+ +-+ + + +-+ +-+-+-+ + +-+-+ + +-+ + +-+ + +-+-+ +-+ + + + +
|   | |   | |   | |   | |   |   | | |   |     | | | |   |   |     | |       |     |   |   |     |   | |       |   | | | |
+-+-+ +-+-+ + +-+ + + + +-+ +-+ + +-+ +-+ + + + + + + +-+ + +-+-+-+ +-+-+-+ + +-+-+-+-+ +-+-+-+-+ + + +-+-+ +-+-+-+ +-+ +
|   | |   | |       | |     | | |     |   | |     |   |   |   |   | |       |   |   |         |   | | |         |   |   |
+-+ + + +-+ +-+-+-+-+ +-+-+-+ + +-+-+-+ +-+ +-+ +-+-+-+-+ +-+ + + + + +-+ +-+-+ + + + +-+-+-+ + +-+ + +-+-+-+-+ + +-+ +-+
|   |     |   |   |   |   |     |   | | | | |   |   |   |   |   |   | | | |   |   | |   |   |   | | |           |   |   |
+ +-+ +-+ +-+ + + + +-+ +-+ +-+-+ + + + + + + +-+ + + + +-+ +-+-+-+-+ + + + + +-+-+-+-+ +-+ +-+-+ + +-+-+-+-+ +-+-+ +-+ +
| |   | | |   | |   | |     |     |   | |   | |   | | |   |   |   |   | |   | |         |   | |   |     | |   |   |     |
+ + +-+ + +-+ + + +-+ +-+ +-+ +-+-+-+-+ +-+-+ + +-+ + +-+ + +-+ + + +-+ +-+-+ + +-+ + +-+ +-+ + +-+-+-+ + + +-+-+ +-+-+ +
| |     |     | |       |               |     |   | | | | |     | |       |   | |   |   |     | | |     |   |   | |   | |
+ +-+-+-+ +-+-+ +-+-+ +-+-+ + +-+-+-+-+-+ +-+-+ + +-+ + + + +-+-+ +-+-+ +-+ +-+ + +-+-+ +-+ + + + + +-+-+-+-+ + + + + + +
|   |     |   |   | | |   | | |   | |     |   | |   |   | | |   | |   |   |     | | |   |   | | |     |       | |   | | |
+-+ + +-+-+ +-+-+ + + + +-+ + + + + + +-+-+ + + +-+ +-+-+ + + + + + +-+-+ +-+-+-+ + + +-+-+-+ + +-+-+ + +-+ +-+ +-+-+ + +
|     |           |   |     |   |   |       |   |         |   | |         |       |   |                 |   |         |X|
+-+-+-+-+-+-+-+-+-+-+-+-+-+-+-+-+-+-+-+-+-+-+-+-+-+-+-+-+-+-+-+-+-+-+-+-+-+-+-+-+-+-+-+-+-+-+-+-+-+-+-+-+-+-+-+-+-+-+-+-+